# lvlwidth 21
# lvlheight 25
# bgcolor 0 0 0
# edgecolor 0 0 255
# fillcolor 0 0 0
# pelletcolor 255 255 255
# fruittype 1

# startleveldata
0 0 0 0 0 0 0 0 0 113 21 113 0 0 0 0 0 0 0 0 0 
0 107 100 100 100 100 100 100 100 106 0 105 100 100 100 100 100 100 100 108 0 
0 101 2 2 2 2 2 2 2 2 2 2 2 2 2 2 2 2 2 101 0 
0 101 2 120 2 113 2 111 100 108 2 107 100 112 2 113 2 120 2 101 0 
0 101 2 2 2 101 2 2 2 101 2 101 2 2 2 101 2 2 2 101 0 
0 101 2 111 100 106 2 113 2 110 2 110 2 113 2 105 100 112 2 101 0 
0 101 2 2 2 2 2 101 2 2 2 2 2 101 2 2 2 2 2 101 0 
0 101 2 120 2 111 100 130 100 112 2 111 100 130 100 112 2 120 2 101 0 
0 101 2 2 2 2 2 2 2 2 2 2 2 2 2 2 2 2 2 101 0 
0 105 100 108 2 113 2 111 100 100 100 100 100 112 2 113 2 107 100 106 0 
0 0 0 101 2 101 2 2 2 2 2 2 2 2 2 101 2 101 0 0 0 
111 100 100 106 2 105 112 2 107 112 0 111 108 2 111 106 2 105 100 100 112 
20 0 0 0 2 0 0 2 101 2 2 2 101 2 0 0 2 0 0 0 20 
111 133 100 112 2 111 112 2 105 100 100 100 106 2 111 112 2 111 100 133 112 
0 101 2 2 2 2 2 2 2 2 2 2 2 2 2 2 2 2 2 101 0 
0 101 2 120 2 107 112 2 111 100 100 100 112 2 111 108 2 120 2 101 0 
0 101 2 2 2 101 2 2 2 2 2 2 2 2 2 101 2 2 2 101 0 
0 105 133 112 2 110 2 111 100 100 133 100 100 112 2 110 2 111 133 106 0 
0 0 101 2 2 2 2 2 2 2 101 2 2 2 2 2 2 2 101 0 0 
0 0 101 2 111 112 2 111 108 2 101 2 107 112 2 111 112 2 101 0 0 
107 100 106 2 2 2 2 2 101 2 101 2 101 2 2 2 2 2 105 100 108 
101 2 2 2 111 100 112 2 110 2 110 2 110 2 111 100 112 2 2 2 101 
101 2 120 2 2 2 2 2 2 2 2 2 2 2 2 2 2 2 120 2 101 
101 4 2 2 107 100 100 100 100 108 0 107 100 100 100 100 108 2 2 5 101 
105 100 100 100 106 0 0 0 0 110 21 110 0 0 0 0 105 100 100 100 106 
# endleveldata

# sprites
